vocābulum -ī n	word
ūnus -a -um	one, only
ubi	where
trēs tria	three
tertius -a -um	third
syllaba -ae f	syllable
sex	six
sed	but
secundus -a -um	second, favorable
Rōmānus -a -um	Roman
quoque	also, too
quis quae quid	who, what
quid n	what, anything
prōvincia -ae f	province
prīmus -a -um	first
pēnsum -ī n	task (a thing weighed out, allotment for weaving, task/stint, homework)
paucī -ae -a	few, a few
parvus -a -um	little, small
oppidum -ī n	town
ōceanus -ī m	ocean
numerus -ī m	number
num	…? if, whether
nōn	not
-ne	…? if, whether
multī -ae -a	many, a great many
mīlle, pl mīlia -ium n	thousand
magnus -a -um	big, large, great
littera -ae f	letter
Latīnus -a -um	Latin
īnsula -ae f	island
in prp +abl	in, on, at
imperium -ī n	command, empire
grammatica -ae f	grammar
Graecus -a -um	Greek
fluvius -ī m	river
exemplum -ī n	example, model
et	and, also
sum esse fuisse futūrum	to be
capitulum -ī n	chapter
vir -ī m	man, husband
tuus -a -um	your, yours
titulus -ī m	title
servus -ī m	slave, servant
quot (indēcl)	how many, (as many) as
-que	and
puer -erī m	boy
puella -ae f	girl
pater -tris m	father
pāgina -ae f	page
novus -a -um	new
meus -a -um, voc mī	my, mine
māter -tris f	mother
līberī -ōrum m pl	children
liber -brī m	book
fīlius -ī m	son
fīlia -ae f	daughter
fēmina -ae f	woman
familia -ae f	domestic staff, family
ecce	see, look, here is
duo -ae -o	two
dominus -ī m	master
domina -ae f	mistress
cēterī -ae -a	the other(s), the rest
centum	a hundred
antīquus -a -um	old, ancient, former
ancilla -ae f	female slave, servant
voco, vocāre, vocāvi, vocātus	call, invite
video, vidēre, vīdi, vīsus	see, (pass) seem
verbum -ī n	word, verb
verberō, verberāre, verberāvī, verberātus	beat, flog
veniō, venīre, vēnī, ventum	come
scaena -ae f	scene, stage
rideo rīdēre rīsi rīsum	laugh, make fun of
rēspondeō, rēspondēre, rēspondī, rēsponsum	answer
quia	because
quī quae quod	who, which, he who
pulso, pulsāre, pulsavi, pulsatus	strike, hit, knock (at)
probus -a -um	good, honest, proper
plōrō, plōrāre, plōrāvī, plōrātum	cry
persōna -ae f	mask, role, character, person
ō	o!
ne-que/nec	and/but not, nor, not
mamma -ae f	mommy
laetus -a -um	glad, happy
īrātus -a -um	angry
interrogo, interrogāre, interrogavi, interrogatus	ask, question
im-probus -a -um	bad, wicked (not up to standard?)
iam	now, already
hīc	here
ego mē mihi/mī	I, me, myself
dormiō, dormīre, dormivī, dormītus	sleep
cūr	why
cantō, cantāre, cantāvī, cantātus	sing
audiō, audīre, audīvī, audītum	hear, listen
vacuus -a -um	empty
tantum	so much, only
taceo, tacēre, tacui, tacitus	be silent
suus -a -um	his/her/their (own)
sūmo, sūmere, sūmpsī, sūmptum	take
septem	seven
salvē -ēte	hello, good morning
salūtō, salūtāre, salūtāvī, salūtātus	greet
sacculus -ī m	purse
rūrsus	again
quod n	what, which, that which
quīnque	five
quattuor	four
pōno, pōnere, posuī, positum	place, put, lay down
pecūnia -ae f	money
pāreo, pārēre, pāruī, pāritum	obey
octō	eight
nummus -ī m	coin, sesterce
numero, numerāre, numeravi, numeratus	count
nūllus -a -um	no
novem	nine
mēnsa -ae f	table
is ea id	he, she, it
habeō, habēre, habuī, habitum	have, hold, consider
discēdō, discēdere, discessī, discessum	go away, depart
decem	ten
bonus -a -um	good
baculum -ī n	stick
adsum, adesse, adfuī, adfutūrus	be present, stand by
accūso, accūsāre, accūsāvī, accūsātus	accuse
absum, abesse, āfuisse, afuturus	be absent/away/distant
vīlla -ae f	country house, villa
sōlus -a -um	alone, lonely
sine prp +abl	without
rosa -ae f	rose
pulcher -chra -chrum	beautiful, fine
peristylum -ī n	peristyle, the part of a building enclosing a courtyard with columns on the inside
ōstium -ī n	door, entrance
nāsus -ī m	nose
līlium -ī n	lily
impluvium -ī n	water basin
hortus -ī m	garden
habitō, habitāre, habitāvī, habitātus	dwell, live
foedus -a -um	ugly, hideous
fenestra -ae f	window
ex/ē prp +abl	out of, from, of, since
etiam	also, even, yet
dēlectō, dēlectāre, dēlectāvī, dēlectātus	delight, please
cum prp +abl	with
cubiculum -ī n	bedroom
carpō, carpere, carpsī, carptum	gather, pick, crop
ātrium -ī n	main room, hall
aqua -ae f	water
amō amāre amāvī amātus	love
agō, agere, ēgī, āctus	drive, do, perform
age -ite +imp	come on! well, now
via -ae f	road, way, street
veho vehere vēxi vectus	bear, carry, convey; pass, ride, sail
unde	from where
umerus -ī m	shoulder
timeō, timēre, timuī, --	fear, be afraid (of)
tam	so, as
saccus -ī m	sack
quō adv	where (to)
quam	how, as, than
prope prp +acc, adv	near, nearly
procul	far (from), far away
post prp +acc, adv	behind, after, later
porto, portāre, portavi, portatus	carry
porta -ae f	gate
per prp +acc	through, by, during
passus -ūs m	pace (1.48 m)
nam	for
mūrus -ī m	wall
malus -a -um	bad, wicked, evil
longus -a -um	long
lectīca -ae f	litter, sedan
ita-que	therefore
eō, īre, īvī, ītus	go
intrō, intrāre, intrāvī, intrātus	enter
inter prp +acc	between, among, during
in-imīcus -ī m	(personal) enemy
fessus -a -um	tired, weary
equus -ī m	horse
duo-decim	twelve
circum prp +acc	round
autem	but, however, moreover
apud prp +acc	beside, near, by
ante prp +acc, adv	in front of, before
amīcus -ī m	friend
amīca -ae f	girlfriend
ambulo, ambulāre, ambulavi, ambulatus	walk
ad prp +acc	to, toward, by, at, till
ā/ab/abs prp +abl	from, of, since, by
vertō, vertere, vertī, versum	turn, change
tergeō, tergēre, tersī, tersus	wipe
tenēre -uisse -ntum	hold, keep (back)
speculum -ī n	mirror
sōlum adv	only
sē sibi	himself
plēnus -a -um (+gen/abl)	full (of)
pirum -ī n	pear
ōstiārius -ī m	door-keeper, porter
ōsculum -ī n	kiss
oculus -ī m	eye
nōn-ne	not?
neque ….neque	neither…nor
mare -is n	sea
mālum -ī n	apple
lacrimāre	shed tears, weep
lacrima -ae f	tear
in-esse	be (in)
in prp +acc	into, to, against
immō	no, on the contrary
illīc	there
hic haec hoc	this
fōrmōsus -a -um	beautiful
ex-spectāre	wait (for), expect
exeō, exīre, exiī, exitum	go out
et…et	both…and
ē v. ex/ē	out of, from
dare dedisse datum	give
currō, currere, cucurrī, cursum	run
claudere -sisse -sum	shut, close
aperīre -uisse -rtum	open, disclose
adveniō, advenīre, advēnī, adventum	arrive
adeo, adīre, adivī, aditus	go to, approach
vīgintī	twenty
vēndo, vēndere, vēndidī, vēnditum	sell
tantus -a -um	so big, so great ; only
tabernārius -ī m	shopkeeper
taberna -ae f	shop, stall
sēstertius -ī m	sesterce (silver coin)
satis	enough, rather
quī quae quod (…?)	what, which
quārtus -a -um	fourth
quantus -a -um	how large, (as large) as
pretium -ī n	price, value
pecūniōsus -a -um	wealthy
ostendō, ostendere, ostendī, ostentus	show
ōrnāre	equip, adorn
ōrnāmentum -ī n	ornament, jewel
octōgintā	eighty
nōnāgintā	ninety
nimis	too, too much
mōnstrāre	point out, show
medius -a -um	mid, middle
medium -ī n	middle, center
margarīta -ae f	pearl
līnea -ae f	string, line
ille -a -ud	that, the one, he
gemmātus -a -um	set with a jewel
gemma -ae f	precious stone, jewel
emere ēmisse ēmptum	buy
digitus -ī m	finger
convenīre (ad/+dat)	fit, be fitting ; come together, meet
con-venīre	come together, meet; to fit, be appropriate for
cōnstāre ex	consist of
cōn-stāre -stitisse	be fixed, cost
cōn-sistere -stitisse	stop, halt
collum -ī n	neck
clāmāre	shout
aut	or
a-spicere	look at, look
ānulus -ī m	ring
alius -a -ud	another, other
ac-cipere	receive
ab-īre -eō -iisse	go away
vestīgium -ī n	footprint, trace
vallis -is f	valley
ut	like, as
ūn-dē-centum	ninety-nine
umbra -ae f	shade, shadow
ululāre	howl
timor -ōris m	fear
terra -ae f	earth, ground, country
suprā prp +acc, adv	above
sub prp +abl/acc	under, near
sōl -is m	sun
silva -ae f	wood, forest
rīvus -ī m	brook
reperīre repperisse repertum	find
relinquō, relinquere, relīquī, relictum	leave, leave behind
quaerere -sīvisse -sītum	look for, seek, ask (for)
petere -īvisse -ītum	make for, aim at, attack, seek, ask for, request
pāstor -ōris m	shepherd
pānis -is m	bread, loaf
ovis -is f	sheep
nūbēs -is f	cloud
niger -gra -grum	black
mōns montis (m)	mountain
modus -ī m	manner, way
lupus -ī m	wolf
lūcēre lūxisse	shine
lātrāre	bark
ipse -a -um	himself
im-pōnere	place (in/on), put
iaceō, iacēre, iacuī	lie
herba -ae f	grass, herb
ēsse edō ēdisse ēsum	eat
errāre	wander, stray
dum	while, as long as, till
dūcere -xisse ductum	guide, lead, draw, trace
dēns dentis m	tooth
dēclīnāre	decline, inflect
collis -is m	hill
clāmor -ōris m	shout, shouting
cibus -ī m	food
canis -is m/f	dog
campus -ī m	plain, level ground
caelum -ī n	sky, heaven
bibere -bisse	drink
bālāre	bleat
arbor -oris f	tree
albus -a -um	white
ac-currere -rrisse	come running
vōx vōcis f	voice
volāre	fly
vīvus -a -um	living, alive
vīvo, vīvere, vīxī, vīctum	live, be alive
velle volō voluisse	want, be willing
tenuis -e	thin
sus-tinēre	support, sustain, endure
spīrāre	breathe
rāmus -ī m	branch, bough
quod (= quia)	because, that
pulmō -ōnis m	lung
pullus -ī m	young (of an animal), chick
posse potuisse	be able
piscis -is m	fish
pila -ae f	ball
petasus -ī m	hat
pēs pedis m	foot
per-territus -a -um	terrified
parere -iō peperisse	give birth to, lay
ōvum -ī n	egg
occultāre	hide
nūntius -ī m	messenger, message
nīdus -ī m	nest
nēmō, nēminem, nūllīus, nēminī, nūllō or nūllā	no one, nobody
necesse est	it is necessary
natāre	swim
movēre mōvisse mōtum	move, stir
mortuus -a -um (< morī)	dead
mercātor -ōris m	merchant
lūdō, lūdere, lūsī, lūsum	play
leō -ōnis m	lion
lectus -ī m	bed, couch
homō -inis m	human being, person
folium -ī n	leaf
flūmen -inis n	river
-ficere -iō -fēcisse -fectum	< facere
ferus -a -um	wild
fera -ae f	wild animal
facere -iō fēcisse factum	make, do, cause
ergō	therefore, so
enim	for
deus -ī m, pl deī/diī/dī	god
cum coniūnctiō	when, as
crassus -a -um	thick, fat
-cipere -iō -cēpisse -ceptum	
cauda -ae f	tail
capere -iō cēpisse captum	take, catch, capture
canere, cecinisse, cantus	sing (of), crow, play
cadere cecidisse	fall
bēstia -ae f	beast, animal
avis -is f	bird
audēre ausum esse	dare, venture
asinus -ī m	ass, donkey
a-scendere -disse	climb, go up, mount
aquila -ae f	eagle
animal -ālis n	animal, living being
anima -ae f	breath, life, soul
aliī…aliī	some…others
āla -ae f	wing
āēr -eris m	air
viscera -um n pl	internal organs
venter -tris m	belly, stomach
vēna -ae f	vein
tangere tetigisse tāctum	touch
super prp +acc	on (top of), above
stultus -a -um	stupid, foolish
stāre stetisse	stand
spectāre	watch, look at
sentiō, sentīre, sēnsī, sēnsum	feel, sense, think
sedeō, sedēre, sēdi, sessum	sit
sānus -a -um	healthy, well
sanguis -inis (m)	blood
sānāre	heal, cure
ruber -bra -brum	red
re-venīre	come back
quiētus -a -um	quiet
putāre	think, suppose
pōculum -ī n	cup, glass
pectus -oris n	breast
palpitāre	beat, throb
ōs ōris n	mouth
noster -tra -trum	our, ours
modo	only, just
membrum -ī n	limb
medicus -ī m	physician, doctor
manus -ūs f	hand
male adv	badly, ill
lingua -ae f	tongue, language
labrum -ī n	lip
iubēre iussisse iussum	order, tell
īnfrā prp +acc	below
iecur -oris n	liver
hūmānus -a -um	human
gena -ae f	cheek
gaudeo, gaudēre, gavisum esse	be glad, be pleased
frōns -ontis f	forehead
fluo, fluere, flūxī, flūxum	flow
dolēre	hurt, feel pain, grieve
dīco, dīcere, dīxī, dictum	say, call, speak
dē-tergēre	wipe off
dē prp +abl	(down) from, of, about
culter -tri m	knife
crūs -ūris n	leg
corpus -oris n	body
cor cordis n	heart
color -ōris m	color
cerebrum -ī n	brain
caput -itis n	head, chief, capital
capillus -ī m	hair
bracchium -ī n	arm
bene	well
auris -is f	ear
atque/ac	and, as well
arcessere -īvisse -ītum	send for, fetch
ap-pōnere	place (on), serve
aegrōtāre	be ill
aeger -gra -grum	sick, ill
vester -tra -trum	your, yours
vesperī adv	in the evening
versus -ūs m	line, verse
vāllum -ī n	rampart
trīstis -e	sad
soror -ōris f	sister
scūtum -ī n	shield
sagitta -ae f	arrow
pugnus -ī m	fist
pugnāre	fight
prae-nōmen -inis n	first name
pīlum -ī n	spear, javelin
pedes -itis m	foot-soldier
patria -ae f	native country/town
pars -rtis f	part, direction
op-pugnāre	attack
nōmen -inis n	name, second name, gens name
mīlitāre	serve as a soldier
mīles -itis m	soldier
metus -ūs m	fear
metuere -uisse	fear
levis -e	light, slight
lātus -a -um	broad, wide
in-colere	inhabit
impetus -ūs m	attack, charge
-icere -iō -iēcisse -iectum	lie
iacere -iō iēcisse iactum	throw, hurl
hostis -is m	enemy
hasta -ae f	lance
gravis -e	heavy, severe, grave
gladius -ī m	sword
fugere -iō fūgisse	run away, flee
frāter -tris m	brother
fossa -ae f	ditch, trench
fortis -e	strong, brave
fīnis -is m	boundary, limit, end
ferre tulisse lātum	carry, bring, bear
ex-pugnāre	conquer
exercitus -ūs m	army
equitātus -ūs m	cavalry
eques -itis m	horseman
dux ducis m	leader, chief, general
dīvidere -īsisse -īsum	separate, divide
dē-fendere -disse -ēnsum	defend
contrā prp +acc	against
cognōmen -inis n	third name, nickname
castra -ōrum n pl	camp
brevis -e	short
bellum -ī n	war
barbarus -a -um	foreign, barbarian
avunculus -ī m	(maternal) uncle
armātus -a -um	armed
arma -ōrum n pl	arms
arcus -ūs m	bow
altus -a -um	high, tall, deep
vesper -erī m	evening
vēr vēris n	spring
vel	or
urbs -bis f	city
ūn-dē-trīgintā	twenty-nine
ūndecimus -a -um	eleventh
ūn-decim	eleven
tunc	then
trīgintā	thirty
tre-centī -ae -a	three hundred
tōtus -a -um	the whole of, all
tempus -oris n	time
stēlla -ae f	star
sextus -a -um	sixth
Sextīlis -is (mēnsis)	August
sexāgintā	sixty
septimus -a -um	seventh
September -bris (mēnsis)	September
saeculum -ī n	century
quīntus -a -um	fifth
Quīntīlis -is (mēnsis)	July
quārta pars	fourth, quarter
quandō	when, as
postrēmus -a -um sup	last
ōtiōsus -a -um	leisured, idle
operiō, operīre, operuī, opertum	cover
Octōber -bris (mēnsis)	October
octāvus -a -um	eighth
obscūrus -a -um	dark
nunc	now
nox noctis f	night
November -bris (mēnsis)	November
nōnus -a -um	ninth
nōnae -ārum f pl	5th/7th (of the month)
nōmināre	name, call
nix nivis f	snow
merīdiēs -ēī m	midday, noon, south
mēnsis -is m	month
Mārtius -ī (mēnsis)	March
māne indēcl n, adv	morning, in the morning
Māius -ī (mēnsis)	May
lūx lūcis f	light, daylight
lūna -ae f	moon
lacus -ūs m	lake
kalendārium -ī n	calendar
kalendae -ārum f pl	the 1st (of the month)
Iūnius -ī (mēnsis)	June
Iūlius -ī (mēnsis)	July
item	likewise, also
initium -ī n	beginning
in-cipere -iō coepisse coeptum	begin
imber -bris m	rain, shower
illūstrāre	illuminate, make clear
igitur	therefore, then, so
īdūs -uum f pl	13th/15th (of the month)
Iānuārius -ī (mēnsis)	January
hōra -ae f	hour
hiems -mis f	winter
glaciēs -ēī f	ice
frīgidus -a -um	cold, chilly, cool
fōrma -ae f	form, shape, figure
Februārius -ī (mēnsis)	February
faciēs -ēī f	face
exiguus -a -um	small, scanty
duo-dē-trīgintā	twenty-eight
duo-decimus -a -um	twelfth
du-centī -ae -a	two hundred
dīmidius -a -um	half
diēs -ēī m (f)	day, date
decimus -a -um	tenth
December -bris (mēnsis)	December
coep-	v. incipere
clārus -a -um	bright, clear, loud
cēterus -a -um	remaining
calidus -a -um	warm, hot, f hot water
autumnus -ī m	autumn
Augustus -ī (mēnsis)	August
Aprīlis -is (mēnsis)	April
annus -ī m	year
aestās -ātis f	summer
aequus -a -um	equal, calm
aequinoctium -ī n	equinox
vigilāre	be awake
vestīre	dress
vestīmentum -ī n	garment, clothing
valēre	be strong, be well
valē -ēte	farewell, goodbye
uter-que utra- utrum-	each of the two, both
uter utra utrum	which (of the two), either
tunica -ae f	tunic
tū tē tuī tibi tē	you, yourself
togātus -a -um	wearing the toga
toga -ae f	toga
tabula -ae f	writing-tablet
surgere sur-rēxisse	rise, get up
stilus -ī m	stylus
sordidus -a -um	dirty, mean, base
solēre -itum esse	be accustomed
sinister -tra -trum	left, f the left (hand)
rēs reī f	thing, matter, affair
rēgula -ae f	ruler
quō-modo	how
pūrus -a -um	clean, pure
prīmum adv	first
praeter prp +acc	past, besides, except
poscere poposcisse	demand, call for
parentēs -um m pl	parents
omnis -e	all, every
nūdus -a -um	naked
nihil/nīl	nothing
neuter -tra -trum	neither
multum -ī n, adv	much
mergere -sisse -sum	dip, plunge, sink
lavō, lavāre, lāvī, lautum	wash, bathe
inquit -iunt	(he/she) says/said
induere -uisse -ūtum	put on (clothes)
hodiē	today
gerere gessisse gestum	carry, wear, carry on, do
gallus -ī m	cock, rooster
frīgēre	be cold
ex-citāre	wake up, arouse
dexter -tra -trum	right, f the right (hand)
de-inde/dein	afterward, then, next
cubāre -uisse -itum	lie (in bed)
clausus -a -um	closed, shut
calceus -ī m	shoe
apertus -a -um	open
an	or
alter -era -erum	one, the other, second
af-ferre at-tulisse al-lātum	bring (to, forward, about)
ad-hūc	so far, till now, still
vōs vōbīs	you, yourselves
virga -ae f	rod
vērus -a -um	true, n truth
tum	then
tergum -ī n	back
tacitus -a -um	silent
statim	at once
sī	if
sevērus -a -um	stern, severe
sella -ae f	stool, chair
red-īre -eō -iisse -itum	go back, return
red-dere -didisse -ditum	give back, give
recitāre	read aloud
quid adv	why
pūnīre	punish
prior, prior, prius	first, former, front-
posterior -ius comp	back-, hind-, later
nōs nōbīs	we, us, ourselves
nōn-dum	not yet
nisi	if not, except, but, unless
malum -ī n	evil, trouble, harm
magister -trī m	schoolmaster, teacher
lūdus -ī m	play, game, school
licēre: licet +dat	it is allowed, one may
lectulus -ī m	(little) bed
īnferior -ius comp	lower, inferior
iānua -ae f	door
ex-clāmāre	cry out, exclaim
domī	at home (locativus)
discipulus -ī m	pupil, disciple
dēsinere -siisse	finish, stop, end
cōn-sīdere -sēdisse	sit down
āter -tra -trum	black, dark
at	but
ante-quam	before
vix	hardly
neque/nec vērō	but not
vērō	really, however, but
vereor, verērī, veritus sum	fear
ventus -ī m	wind
vēlum -ī n	sail
turbidus -a -um	agitated, stormy
turbāre	stir up, agitate
tranquillus -a -um	calm, still
tonitrus -ūs m	thunder
tempestās -ātis f	storm
superus -a -um	upper
sī-ve/seu	or, or if
situs -a -um	situated
simul	together, at the same time
servāre	preserve, save
serēnus -a -um	clear, cloudless
sequī secūtum	follow
septentriōnēs -um m pl	north, The Seven Oxen, The Plough
semper	always
puppis -is f	stern, poop
propter prp +acc	because of
proficīscī -fectum	set out, depart
praeter-eā	besides
portus -ūs m	harbor
paulum	a little, little
paulō +comp, ante/post	a little
orīrī ortum	rise, appear
oriēns -entis m	east
ōra -ae f	border, coast
opperīrī -ertum	wait (for), await
oc-cidere -disse	fall, sink, set
occidēns -entis m	west
nāvis -is f	ship
nāvigāre	sail
nauta -ae m	sailor
multō +comp	much, by far
merx -rcis f	commodity, pl goods
maritimus -a -um	sea-, coastal
loquī locūtum	speak, talk
locus -ī m	place
laetārī	rejoice, be glad
lābī lāpsum	slip, drop, fall
iterum	again, a second time
in-vocāre	call upon, invoke
intuērī	look at, watch
inter-esse	be between
īn-fluere	flow into
īnferus -a -um	lower
im-plēre -ēvisse -ētum	fill, complete
iactāre	throw, toss about
hauriō, haurīre, hausī, haustum	draw (water), bail
gubernātor -ōris m	steersman
gubernāre	steer, govern
fulgur -uris n	flash of lightning
flūctus -ūs m	wave
flāre	blow
fiō, fierī, factum esse (fiat, fiunt)	be made, be done, become, happen
ē-gredī -ior -gressum	go out
contrārius -a -um	opposite, contrary
cōn-sōlārī	comfort, console
cōn-scendere -disse	mount, board
cōnārī	attempt, try
complector, complectī, complexus sum	embrace
cernere crēvisse	discern, perceive
appellāre	call, address
altum -ī n	the open sea
ūsque	all the way up (to), all the time
ūn-dē-vīgintī	nineteen
trē-decim	thirteen
tot	so many (Indeclinable)
tollō, tollere, sustulī, sublātum	raise, lift, pick up, remove, take away
ses-centī -ae -a	six hundred
septuāgintā	seventy
septin-gentī -ae -a	seven hundred
septen-decim	seventeen
sē-decim	sixteen
sciō, scīre, scīvī, scītum	know
respōnsum -ī n	answer
re-prehendere	blame, censure; hold back, restrain
re-pōnere	put back
rēctus -a -um	straight, correct
quis-que quae- quod-	each, each one, everyone ; whoever, whatever
quīnquāgintā	fifty
quīn-gentī -ae -a	five hundred
quīn-decim	fifteen
quattuor-decim	fourteen
quā-rē	why
quamquam	although
quadrin-gentī -ae -a	four hundred
quadrāgintā	forty
prūdēns -entis adi	prudent, clever
prōmō, prōmere, prōmpsī, prōmptum	produce, bring out, take out, display
prāvus -a -um	faulty, wrong
postrēmō adv	finally
piger -gra -grum	lazy
partīrī	share, divide
oportēre: oportet	it is right, you should
octin-gentī -ae -a	eight hundred
numquam	never
nōn-gentī -ae -a	nine hundred
ne-scīre	not know
laudāre	praise
largus -a -um	generous
largīrī	give generously
inter-pellāre	interrupt
inimīcus -a -um	unfriendly
industrius -a -um	industrious
in-doctus -a -um	ignorant
in-certus -a -um	uncertain
facilis -e, sup -illimus	easy
duo-dē-vīgintī	eighteen
doctus -a -um	learned, skilled
docēre -uisse doctum	teach, instruct
discere didicisse	learn
dif-ficilis -e, sup -illimus	difficult, hard
dēnārius -ī m	denarius (silver coin , 4 sestertii)
dē-mōns-*trā-re	point out, show
com-putāre	calculate, reckon
cōgitāre	think
certus -a -um	certain, sure
centēsimus -a -um	hundredth
as assis m	as (copper coin)
amīcus -a -um	friendly
aequē	equally
absēns -entis	absent
zephyrus -ī m	west wind
vōcālis -is f	vowel
varius -a -um	varied, different
turpis -e	ugly, foul
totiēs	so many times
ter	three times
tālis -e	such
super-esse	be left, be in excess
significāre	signify, show by signs, indicate, mean
signāre	mark, seal
sīc	in this way, so, thus
sexiēs	six times
sententia -ae f	opinion, sentence
semel	once
scrībere -psisse -ptum	write
rārus -a -um	rare
quotiēs	how many times
quīnquiēs	five times
quater	four times
quālis -e	what sort of, (such) as
premere pressisse pressum	press
papyrus -ī f	papyrus
mollis -e	soft
mercēs -ēdis f	wage, fee, rent
mendum -ī n	mistake, error
māteria -ae f	material, substance
legere lēgisse lēctum	read
iungere iūnxisse iūnctum	join, combine
ita	so, in such a way
intellegere -ēxisse -ēctum	understand, realize
im-primere -pressisse -pressum	press (into)
im-piger -gra -grum	active, industrious
īdem eadem idem	the same
frequēns -entis	numerous, frequent
ferrum -ī n	iron, steel
ex-audīre	hear (clearly, from afar)
erus -ī m	master
epistula -ae f	letter
efficiō, ef-ficere, effēcī, effectum	make, effect, cause
dūrus -a -um	hard
dictāre	dictate
dēlēre -ēvisse -ētum	delete, efface
de-esse dē-fuisse (+dat)	be missing, fail
deciēs	ten times
corrigō, corrigere, corrēxī , corrēctum	correct
cōnsonāns -antis f	consonant
com-parāre	compare
charta -ae f	paper
certē	certainly, at any rate
cēra -ae f	wax
calamus -ī m	reed, pen
bis	twice
bēstiola -ae f	small animal, insect
aut…aut	either…or
apis -is f	bee
anim-ad-vertere	notice
addō, addere, addidī, additum	add
virgō -inis f	maiden, young girl
uxor -ōris f	wife
nec/neque ūllus	and no
ūllus -a -um	any
templum -ī n	temple
tēctum -ī n	roof
tamen	nevertheless, yet
signum -ī n	sign, seal, statue
re-mittere	send back
pulchritūdō -inis f	beauty
praeteritus -a -um	past
praesēns -entis (adj)	present
possidēre -sēdisse	possess, own
plūs plūris (n noun and adj)	more
plūrimī -ae -a sup	most, a great many
plūrēs -a comp	more
pessimus -a -um sup	worst
pēior -ius comp	worse
pauper -eris adi	poor
ōsculārī	kiss
opus est	it is needed
optimus -a -um sup	best, very good
mittere mīsisse missum	send, throw
miser -era -erum	unhappy, miserable
minus (adv)	less, not so well (comp parus)
minuō, minuere, minuī, minūtum	diminish, reduce
minor, minus (comp)	smaller, younger
minimus -a -um sup	smallest, youngest
melior -ius comp	better
māximus -a -um	biggest, greatest, oldest
mātrōna -ae f	married woman
marītus -ī m	husband
māior -ius comp	bigger, older
magnificus -a -um	magnificent, splendid
gracilis -e	slender
forum -ī n	square
flōs -ōris m	flower
ergā prp +acc	toward
dōnum -ī n	gift, present
domus -ūs f, abl -ō	house, home
dīves -itis adi	rich, wealthy
dignus -a -um	worthy
dea -ae f	goddess
cotīdiē	every day
coniūnx -iugis m/f	spouse
columna -ae f	column
beātus -a -um	happy
augēre -xisse -ctum	increase
amor -ōris m	love
amāns -antis m	lover
adulēscēns -entis m	young man
vīcēsimus -a -um	twentieth
versus: ad…versus	toward
vāgīre	wail, squall
ūnā adv	together
ūmidus -a -um	wet, moist
tata -ae m	daddy
somnus -ī m	sleep
sīve . . . sīve	whether…or
silēre	be silent
silentium -ī n	silence
sermō -ōnis m	talk, conversation
revertor, revertī, reversus sum	return, come back
rārō adv	rarely, seldom
profectō	indeed, certainly
postulāre	demand, require
pergere per-rēxisse	proceed, go on
parvulus -a -um	little, tiny
officium -ī n	duty, task
oc-currere -rrisse +dat	meet, (run to) meet
nūtrīx -īcis f	nurse
nōlle nōluisse	be unwilling, not want
nōlī -īte +īnf	don’t…!
necessārius -a -um	necessary
mulier -eris f	woman
mox	soon
minimē	by no means, not at all
manēre mānsisse	remain, stay
magis	more
lac lactis n	milk
īnfāns -antis m/f	little child, baby
gradus -ūs m	step, degree
tempus futūrum	future
futūrus -a -um (v. esse)	future
fīliolus -ī m	little son
fīliola -ae f	little daughter
fārī	speak
domum adv	home
dīligere -ēxisse -ēctum	love, be fond of
decēre	be fitting, become
dēbēre	owe, be obliged
cūrāre	care for, look after, take care
cūnae -ārum f pl	cradle
crās	tomorrow
colloquium -ī n	conversation
col-loquī	talk, converse
carēre +abl	be without, lack
aliēnus -a -um	someone else’s
alere -uisse altum	feed
adversus/-um prp +acc	toward, against
ad-vehere	carry, convey (to)
vincō, vincere, vīcī, victum	defeat, overcome, win
vestis -is f	clothing
validus -a -um	strong
tabella -ae f	writing-tablet
sordēs -ium f pl	dirt
solum -ī n	floor, lowest part; soil, ground
pugna -ae f	fight
post-quam	after, since
porcus -ī m	pig
nārrāre	relate, tell
mūtāre	change, exchange
mundus -a -um	clean, neat
nūllō modō	by no means
mentīrī	lie
interim	meanwhile
in-dignus -a -um	unworthy, shameful
humus -ī f	ground, soil, earth
humī (loc)	on the ground
genū -ūs n	knee
falsus -a -um	false
fallere fefellisse falsum	deceive
ex-cūsāre	excuse (cf. ac-cūsō, ad/ex causa)
dubitāre	doubt
cum prīmum +perf	as soon as
cruor -ōris m	blood (from wound), gore
crēdere -didisse +dat	believe, trust, entrust
cornū -ūs n	horn
cōnspicio, cōnspicere, cōnspexī, cōnspectus	catch sight of, see, observe, watch
cognōscō, cognōscere, cognōvī, cognitum	get to know, recognize
causa -ae f	cause, reason
candidus -a -um	white, bright
bōs bovis m/f	ox
angustus -a -um	narrow
ali-quis -quid	someone, something
āiō (ais, ait, āiunt)	say
ain'	really? (aisne?, did you say?)
vincīre -nxisse -nctum	tie
tremere -uisse	tremble
terrēre	frighten
tandem	at length, at last
tabellārius -ī m	letter-carrier
solvere -visse solūtum	untie, discharge, pay
sinere sīvisse situm	let, allow
sīc-ut	just as, as, in the same way
scindere scidisse scissum	tear, tear up
scīlicet	of course
salīre -uisse	jump
rumpere rūpisse ruptum	break
rogitāre	ask (repeatedly)
re-tinēre -uisse -tentum	hold back
re-sistere re-stitisse +dat	halt, resist
re-movēre	remove
re-cēdere	go back, retire
quis quid (sī/num/nē…)	anyone, anything
quīn	why not, do…!
prō-cēdere	go forward, advance
prius (adv)	earlier, before, previously, first
prehendere -disse -ēnsum	grasp, seize
post-eā	afterward, later
pellere pepulisse pulsum	push, drive (off)
pallium -ī n	cloak, mantle
nūper	recently
mordēre momordisse -sum	bite
monēre	remind, advise, warn
līmen -inis n	threshold
lignum -ī n	wood
ligneus -a -um	wooden
iste -a -ud	this, that (of yours)
intrā prp +acc	inside, within
imāgō -inis f	picture
iānitor -ōris m	doorkeeper
heus	hey! hello!
fremere -uisse	growl
forīs adv	outside, out of doors
forās adv	out through the doors, out of doors, forth, out
ferreus -a -um	of iron, iron-
ferōx -ōcis adi	fierce, ferocious
faber -brī m	artisan, smith
extrā prp +acc	outside
dē-rīdēre	laugh at, make fun of
cūstōdīre	guard
cēdere cessisse	go, withdraw
cavēre cāvisse cautum	beware (of)
catēna -ae f	chain
cardō -inis m	door pivot, hinge
aurum -ī n	gold
aureus -a -um	gold-, m gold piece
arbitrārī	think, suppose, believe
anteā	before, formerly
ad-mittere	let in, admit
ac-cēdere	approach, come near
vultus -ūs m	countenance, face
verbera -um n pl	lashes, flogging
nec/neque umquam	and never
umquam	ever
trā-dere -didisse -ditum	hand over, deliver
superior -ius comp	higher, upper, superior
salūtem dīcere +dat	greet
rubēre	be red, blush
quis-nam quid-nam	who/what ever?
pudor -ōris m	(sense of) shame
pudēre: pudet mē (+gen)	I am ashamed (of)
prō-mittere	promise
prōmissum -ī n	promise
posthāc	from now on, hereafter
plānus -a -um	plain, clear
plānē	plainly, clearly
perdere perdisse perditum	destroy, ruin, waste
pallidus -a -um	pale
pallēre	be pale
ob prp +acc	on account of
negāre	deny, say that…not
-nam	…ever?
merēre	earn, deserve
laus laudis f	praise
inter sē	(with) one another
integer -gra -grum	undamaged, intact
īn-scrībere	write on, inscribe
in-clūdere -sisse -sum	shut up
illinc	from there, thence
hinc	from here, hence
herī	yesterday
fortasse	perhaps, maybe
fatērī fassum	admit, confess
factum -ī n	deed, act
facile adv	easily
dī-mittere	send away, dismiss
con-tinēre -uisse -tentum	contain
comitārī	accompany
comes -itis m	companion
clāvis -is f	key
ā-vertere	turn aside, avert
ante-hāc	formerly
valdē	strongly, very (much)
tumultus -ūs m	uproar
subitus -a -um	sudden
subitō adv	suddenly
strepitus -ūs m	noise, din
sonus -ī m	sound, noise
saepe	often
re-cumbere -cubuisse	lie down
prīmō adv	at first
per-cussum	struck
per-cutere -iō -cussisse	strike, hit
patī passum	suffer, undergo, bear
pār paris adi	equal
os ossis n	bone
nōvisse (< nōscere)	know
nōscere nōvisse	get to know, perf know
mīrārī	wonder (at), be surprised
latus -eris n	side, flank
laevus -a -um	left
iūxtā prp +acc	next to, beside
intus adv	inside
im-pār -aris adi	unequal
ignōrāre	not know
frangere frēgisse frāctum	break, shatter
flēre -ēvisse	cry, weep (for)
et-sī	even if, although
dolor -ōris m	pain, grief
dē-nuō	anew, again
cupere -iō -īvisse	desire
cruentus -a -um	blood-stained, bloody
con-vertere	turn
continuō adv	immediately
cēterum adv	besides, however
certō adv	for certain
aliter	otherwise
ali-quī -qua -quod	some
aegrōtus -a -um	sick
vorāre	swallow, devour
trahere trāxisse tractum	drag, pull
timidus -a -um	fearful, timid
terribilis -e	terrible
taurus -ī m	bull
nāvem solvere	cast off, set sail
saxum -ī n	rock
saevus -a -um	fierce, cruel
rēx rēgis m	king
regere, rēxī, rēctum	rule, direct, guide, govern
quot-annīs	every year
prōspiciō, prōspicere, prōspexī, prōspectus	look out, look ahead
polliceor, pollicērī, pollicitus sum	promise
pateō, patēre, patuī, -	be open
parātus -a -um	ready
ōlim	once, long ago
occīdō, occīdere, occīdī, occīsus	kill
oblīvīscī -lītum +gen/acc	forget
nex necis f	killing, murder
necō, necāre, necāvī, necātus	kill
nārrātiō -ōnis f	narrative
mors mortis f	death
mora -ae f	delay
mōnstrum -ī n	monster
moenia -ium n pl	walls
mīrābilis -e	marvelous, wonderful
maereō, maerēre, --, --	grieve
lītus -oris n	beach, shore
labyrinthus -ī m	labyrinth
inter-ficere	kill
illūc	there, thither
ibi	there
humilis -e	low
hūc	hither, to this place
glōria -ae f	glory
forte adv	by chance
fīlum -ī n	thread
fābula -ae f	story, fable, play
ex-pugnātiō -ōnis f	conquest
exitus -ūs m	exit, way out, end
dēserō, dēserere, dēseruī, dēsertum	leave, desert
dēscendō, dēscendere, dēscendī, dēscensus	go down, descend
currus -ūs m	chariot
cupidus -a -um (+gen)	desirous (of), eager (for)
cupiditās -ātis f	desire
cōnstituō, cōnstituere, cōnstituī, cōnstitūtus	fix, decide
cōnspectus -ūs m	sight, view
com-plūrēs -a	several
cīvis -is m/f	citizen, countryman
brevī adv	soon, in a short time, shortly
auxilium -ī n	help, assistance
agnus -ī m	lamb
aedificium -ī n	building
aedificāre	build
vērum	but
ūrere ussisse ustum	burn
trāns prp +acc	across, over
temerārius -a -um	reckless
tam-quam	as, like
sūrsum	up, upward
summus -a -um sup	highest, greatest
studiōsus -a -um (+gen)	interested (in)
sīn Sīn volābis in summō aere prope caelum, ignis sōlis cēram molliet atque pennās ūret.	but if
revocāre	call back, revoke
reliquus -a -um	remaining, left
rēctā (viā)	straight
quoniam Quoniam māiōrem fābulae partem iam nārrāvistī, partem reliquam quoque nārrāre dēbēs.	as, since
neque/nec quisquam	and no one
quis-quam	anyone
quidem	indeed, certainly
quatere -iō	shake
propinquus -a -um	near, close
per-sequī	follow, pursue
per-ficere	complete, accomplish
penna -ae f	feather
paen-īnsula -ae f	peninsula
paene	nearly, almost
orbis terrārum	the world
orbis -is m	circle, orbit
opus -eris n	work
nātūra -ae f	nature
multitūdō -inis f	large number, multitude
molliō, mollīre, mollīvī, mollītus	make soft, soften
māximē	most, especially
lībertās -ātis f	freedom, liberty
līber -era -erum	free
levāre	lift, raise
lacertus -ī m	(upper) arm
iuvāre iūvisse iūtum	help, delight
inveniō, invenīre, invēnī, inventus	find
ingēns -entis adi	huge, vast
īnfimus -a -um sup	lowest
im-mātūrus -a -um	unripe
imitor, imitārī, imitātus sum	imitate
ignis -is m	fire
haud	not at all, by no means
fuga -ae f	flight
fīgo, fīgere, fīxi, fīxus	fix, fasten
excōgitāre	think out, devise
ēvolāre	fly out
effugiō, effugere, effūgī, effugitus	escape, run away
dēspiciō, dēspicere, dēspexī, dēspectus	look down (on), despise
deorsum adv	down
cōnsūmō, cōnsūmere, cōnsūmpsī, cōnsūmptus	spend, consume
cōnsilium -ī n	advice, decision, intention, plan
cōn-sequī	follow, overtake
cōnficiō, cōnficere, confēcī, cōnfectus	make, accomplish
celer -eris -ere	swift, quick
cautus -a -um	cautious
gen (/meā) +causā	for the sake of
cāsus -ūs m	fall, case
carcer -eris m	prison
audāx -ācis adi	bold, audacious
ars artis f	art, skill
accidō, accidere, accidisse, accisus Quid tum accidit? Quod filiō Daedalīaccidit, idem omnī puerō accidere poterit.	happen, occur
aberrāre	wander away, stray
vītis -is f	vine
vīnum -ī n	wine
vīnea -ae f	vinyard
-ve	or
ūva -ae f	grape
ūtī ūsum +abl	use, enjoy
ut + coni	that, in order that, to
urbānus -a -um	of the city, urban
trīcēsimus -a -um	thirtieth
alterum tantum	twice as much
tantum -ī n	so much
sub-urbānus -a -um	near the city
spargere -sisse -sum Agricola semen manu spargit. Pastorem mittunt atque celeriter oves in agris sparsas persequuntur.	scatter
siccus -a -um	dry
serere sēvisse satum	sow, plant
sēmen -inis n	seed
rūsticus -a -um	rural, rustic, farm-
rūs rūris n	the country
rūrī loc	in the country
rudis -e	crude, rude
rigāre	irrigate
regiō -ōnis f	region, district
rapere -iō -uisse -ptum	tear away, carry off
quiēscere -ēvisse	rest
neque/nec quidquam	and nothing
quid-quam	anything
nē quidem	not even
quī-dam quae- quod-	a certain, some
quam +sup	as…as possible
prō-icere	throw (forward)
pro-hibēre	keep off, prevent
prōd-esse prō-fuisse +dat	be useful, do good
prō prp +abl	for, instead of
precēs -um f pl	prayers
praedium -ī n	estate
prae prp +abl	before, for
pecus -oris n	livestock, sheep, cattle
patientia -ae f	forbearance, patience
patiēns -entis adi	patient
pāscere pāvisse pāstum	pasture, feed, feast
parum	too little, not quite
pābulum -ī n	fodder
ōtium -ī n	leisure
ōrāre	pray, beg
nocēre +dat	harm, hurt
nē-ve/neu	and (that) not, nor
nēquam adi indēcl, comp nēquior, sup nēquissimus	worthless, bad
negōtium -ī n	business, activity
neglegere -ēxisse -ēctum	neglect
neglegēns -entis adi	careless
nē…quidem	not even
nē	that not, lest, that
metere	reap, harvest
mātūrus -a -um	ripe
loca -ōrum n pl	regions, parts
lāna -ae f	wool
labōrāre	toil, work, take trouble
labor -ōris m	work, toil
invehere	import
īnstrūmentum -ī n	tool, instrument
in-hūmānus -a -um	inhuman
grex -egis m	flock, herd, band
gravida adi f	pregnant
frūmentum -ī n	corn, grain
frūgēs -um f pl	fruit, crops
frīgus -oris n	cold
fertilis -e	fertile
falx -cis f	sickle
ex-īstimāre	consider, think
dēnique	finally, at last
cūra -ae f	care, anxiety
crēscere -ēvisse	grow
cōpia -ae f	abundance, lot
colōnus -ī m	(tenant-) farmer
colere -uisse cultum	cultivate
circā prp +acc	round
cingere cīnxisse cīnctum	surround
cēnsēre -uisse -sum	think
calor -ōris m	warmth, heat
arātrum -ī n	plough
arātor -ōris m	plowman
arāre	plow
amoenus -a -um	lovely, pleasant
agricola -ae m	farmer, peasant
ager -grī m	field
abs v. ā/ab/abs	from, away from
vorāgō -inis f	abyss, whirlpool
vītāre	avoid
vigilia -ae f	night watch (I-IV)
versārī	move about, be present
vel-ut	like, as
utrum…an	…or…? whether…or
ūniversus -a -um	the whole of, entire
tūtus -a -um	safe
turba -ae f	throng, crowd
tumultuārī	make an uproar
tranquillitās -ātis f	calmness
tībīcen -inis m	flute-player
tībiae -ārum f pl	flute
suscitāre	wake up, rouse
surdus -a -um	deaf
spērāre	hope (for)
servīre +dat	be a slave, serve
salvus -a -um	safe, unharmed
salvāre	save
rogāre	ask, ask for
rēgnāre	reign, rule
quadrāgēsimus -a -um	fortieth
prīnceps -ipis m	chief, leader
praedō -ōnis m	robber, pirate
potius	rather
potestās -ātis f	power
phantasma -atis n	ghost, apparition
per-venīre	get to, reach
per-suādēre -sisse +dat	persuade, convince
per-īre -eō -iisse	perish, be lost
perīculum -ī n	danger, peril
perīculōsus -a -um	perilous, dangerous
pecūlium -ī n	money given to slaves
ob-oedīre +dat	obey
nāvicula -ae f	boat
XX annōs nātus	20 years old
nātus -a -um (< nāscī)	born
nāscī nātum	be born
mūtus -a -um	dumb
mundus -ī m	world, universe
mortālis -e	mortal
morī mortuum	die
memorāre	mention
mālle māluisse	prefer
libellus -ī m	little book
Īnferī -ōrum m pl	the underworld
im-pendēre +dat	threaten
im-mortālis -e	immortal
fretum -ī n	strait
fāma -ae f	rumor, reputation
ex-tendere -disse -tum	stretch out, extend
ē-volvere -visse -lūtum	unroll
eō adv	to that place, there
ē-icere	throw out
dis-iungere	separate
dictum -ī n	saying, words
cōnstāns -antis adi	steady, firm
claudus -a -um	lame
cessāre	leave off, cease
caecus -a -um	blind
attentus -a -um	attentive
ap-prehendere	seize
animus -ī m	mind, soul
ad-ōrāre	worship, adore
ad-mīrārī	admire, wonder at
vīta -ae f	life
vestrum gen	of you
vēlōx -ōcis adi	swift, rapid
tyrannus -ī m	tyrant
trīstitia -ae f	sadness
su-spicere	look up (at)
sur-ripere -iō -uisse -reptum	steal
sub-īre -eō -iisse	go under, undergo
suādēre -sisse +dat	advise
stupēre	be aghast
spēs -eī f	hope
sēsē	himself
secāre -uisse -ctum	cut
salūs -ūtis f	safety, well-being
repente	suddenly
rēmus -ī m	oar
re-manēre	remain, stay behind
re-dūcere	lead back, bring back
re-cognōscere	recognize
rapidus -a -um	rushing, rapid
querī questum	complain, grumble
quasi	as, like, as if
prōtinus	at once
pretiōsus -a -um	precious
precārī	pray
piscātor -ōris m	fisherman
per-turbāre	upset
per-movēre	move deeply
per-mittere	allow, permit
parcere pepercisse +dat	spare
nōtus -a -um	known
nostrum gen	of us
nōn-numquam	sometimes
nōn-nūllī -ae -a	some, several
nōbilis -e	well known, famous
nāvigātiō -ōnis f	sailing, voyage
mīrus -a -um	surprising, strange
maleficium -ī n	evil deed, crime
maestus -a -um	sad, sorrowful
lucrum -ī n	profit, gain
laetitia -ae f	joy
invidia -ae f	envy
in-vidēre +dat	envy, grudge
inde	from there, thence
ignōtus -a -um	unknown
ignārus -a -um	ignorant, unaware
iactūra -ae f	throwing away, loss
heu	o! alas!
fūrtum -ī n	theft
fūr -is m	thief
fundus -ī m	bottom
frūstrā	in vain
fortūna -ae f	fortune
fīnīre	limit, finish
fidicen -inis m	lyre-player
fidēs -ium f pl	lyre
fēlīx -īcis adi	fortunate, lucky
fēlīcitās -ātis f	good fortune, luck
fallāx -ācis adi	deceitful
ex-pōnere	put out/ashore, expose
ē-ripere -iō -uisse -reptum	snatch away, deprive of
dorsum -ī n	back
dōnāre	give, present with
dīvitiae -ārum f pl	riches
dē-trahere	pull off
dē-terrēre	deter
dē-spērāre	lose hope, despair (of)
dē-silīre -uisse	jump down
delphīnus -ī m	dolphin
cōn-fitērī -fessum	confess
celsus -a -um	tall
carmen -inis n	song, poem
cantus -ūs m	singing, music
beneficium -ī n	benefit, favor
ap-propinquāre (+dat)	approach, come near
ap-pārēre	appear
ā-mittere	lose
allicere -iō -ēxisse -ectum	attract
af-ficere	affect, stir
aestimāre	value, estimate
ad-icere	add
abs-tinēre	keep off
ab-icere	throw away
vīsere -sisse	go and see, visit
vās vāsis n, pl -a -ōrum	vessel, bowl
valētūdō -inis f	health
trīclīnium -ī n	dining-room
ternī -ae -a	three (each)
tardus -a -um	slow, late
sternere strāvisse strātum	spread
sitis -is f	thirst
singulī -ae -a	one (each), each
sānē	certainly, quite
salvēre iubēre	greet
sāl salis m	salt, wit
re-quiēscere	rest
re-cipere	receive, admit
prō-ferre	bring forth, produce
prīdem	long ago
prae-esse (+dat)	be in charge (of)
pōtāre	drink
placēre +dat	please
per-ferre	carry, endure
paulisper	for a short time
parāre	prepare, make ready
nux nucis f	nut
nūntiāre	announce, report
molestus -a -um	troublesome
miscēre -uisse mixtum	mix
minister -trī m	servant
merus -a -um	pure, neat, undiluted
merum -ī n	neat wine
mēnsa secunda	dessert
mel mellis n	honey
lībertīnus -ī m	freedman
līberāre	free, set free
iūcundus -a -um	pleasant, delightful
iter itineris n Nuper longum iter feci in Graeciam. In itinere cohortes alia post aliam in longo ordine progrediuntur.	journey, march, way
in-exspectātus -a -um	unexpected
indūtus +abl	dressed in
īmus -a -um sup	lowest
hospes -itis m	guest, guest-friend
holus -eris n	vegetable
gustāre	taste
glōriōsus -a -um	glorious, boastful
genus -eris n	kind, sort
fundere fūdisse fūsum	pour, shed
fruī +abl Post tanta negotia magis quam umquam otio fruor. Nec vero iucunde vivo nisi cotidie bono vino fruor.	enjoy
famēs -is f	hunger, famine
ex-ōrnāre	adorn, decorate
ex-haurīre	drain, empty
equidem	indeed, for my part
ē-ligere -lēgisse -lēctum	choose, select
dulcis -e	sweet
diū, comp diūtius	long
dīligēns -entis adi	careful, diligent
dēmum adv	at last, only
culīna -ae f	kitchen
coquere -xisse -ctum	cook
convīvium -ī n	dinner-party
convīva -ae m/f	guest
con-trahere	draw together, wrinkle
com-plēre -ēvisse -ētum	fill, complete
cocus -ī m	cook
circiter	about
cēnāre	dine, have dinner
cēna -ae f	dinner
carō carnis f	flesh, meat
bonum -ī n	good, blessing
bīnī -ae -a	two (each)
balneum -ī n	bath, bathroom
a-spergere -sisse -sum	sprinkle, scatter (on)
argentum -ī n	silver
argenteus -a -um	silver-, of silver
ap-portāre	bring
acūtus -a -um	sharp
acerbus -a -um	sour, bitter
ac-cumbere -cubuisse	lie down at table
ac-cubāre	recline at table
vetus -eris adi	old
vetāre	forbid
supplicium -ī n	(capital) punishment
super prp +abl	on, about
statuere -uisse -ūtum	fix, determine
simul atque +perf	as soon as
senex senis m	old man
scelus -eris n	crime
scelestus -a -um	criminal, wicked
sapiēns -entis adi	wise
rūmor -ōris m	rumor
re-trahere	pull back, bring back
quis-quis	whoever, anyone who
quid-quid	whatever, anything that
quantum -ī n	how much, (as much) as
quam-ob-rem	why
prius-quam	before
praemium -ī n	reward, prize
pōtiō -ōnis f	drinking, drink
poena -ae f	punishment, penalty
parricīda -ae m	parricide
optāre	wish
ōdisse	hate
nūgae -ārum f pl	idle talk, rubbish
nōnāgēsimus -a -um	ninetieth
nimius -a -um	too big
nimium	too much
namque	for
mūnus -eris n	gift
mōs mōris m	custom, usage
memoria -ae f	memory
longē	far, by far
lēx lēgis f	law
latēre	be hidden, hide
iuvenis -is m	young man
iūstus -a -um	just, fair
iūs iūris n	right, justice
in-validus -a -um	infirm, weak
īnscrīptiō -ōnis f	inscription
in-iūstus -a -um	unjust, unfair
iniūria -ae f	injustice, wrong
īn-fidus -a -um	faithless
īn-fēlīx -īcis adi	unlucky, unfortunate
im-patiēns -entis adi	impatient
ignōscere -ōvisse +dat	forgive
id-eō	for that reason
funditus adv	to the bottom, utterly
fugitīvus -a -um	runaway
fīdus -a -um	faithful, reliable
fidēs -eī f	trust, faith, loyalty
fīdere fīsum esse +dat	trust, rely on
fābulārī	talk, chat
ēducāre	bring up
ēbrius -a -um	drunk
dēbilis -e	weak
crux -ucis f	cross
crūdēlis -e	cruel
cruciāre	torture, torment
cōram prp +abl	in the presence of
cōn-fidere +dat	trust
clēmēns -entis adi	mild, lenient
avārus -a -um	greedy, avaricious
au-fugere	run away, escape
au-ferre abs-tulisse ablātum	carry off, take away
asinīnus -a -um	ass’s
ali-quantum	a good deal
ab-dūcere	take away, carry off
voluntās -ātis f	will
vīs, acc vim, abl vī	force, violence, power
vīrēs -ium f pl	strength
vīlis -e	cheap
victōria -ae f	victory
victor -ōris m, adi	conqueror, victorious
utinam	I wish that, if only…!
ubī-que	everywhere
ubi prīmum +perf	as soon as
tuērī tūtum	guard, protect
talentum -ī n	talent
superbus -a -um	haughty, proud
sub-mergere	sink
seu	or
servitūs -ūtis f	slavery
re-pugnāre	fight back, resist
re-minīscī +gen/acc	recollect
rēmigāre	row
red-imere -ēmisse -ēmptum	ransom
proximus -a -um sup	nearest
prae-pōnere +dat	put before/in charge of
praeferre	prefer
populus -ī m	people, nation
poēta -ae m/f	poet
pīrāta -ae m	pirate
per-currere -rrisse -rsum	run over, pass over
of-ferre ob-tulisse oblātum	offer
nūbilus -a -um	cloudy
neu	and (that) not, nor
mūtuum dare/sūmere	lend/borrow
mūtuus -a -um	on loan
minārī +dat	threaten
mercātōrius -a -um	merchant-
meminisse +gen/acc	remember, recollect
iūre	justly, rightly
internus -a -um	inner, internal
inter-eā	meanwhile
inopia -ae f	lack, scarcity
īnfēstus -a -um	unsafe, infested
in-ermis -e	unarmed
incola -ae m/f	inhabitant
grātus -a -um	pleasing, grateful
grātiās agere	thank
grātiam habēre	be grateful
gen (/meā) + grātiā	for the sake of
grātia -ae f	favor, gratitude
gēns gentis f	nation, people
flectere -xisse -xum	bend, turn
etiam-nunc	still
ēgregius -a -um	outstanding, excellent
ē-dūcere	bring out, draw out
dōnec	as long as
dis-suādēre	advise not to
dē-sistere -stitisse	leave off, cease
cursus -ūs m	race, journey, course
cūnctus -a -um	whole, pl all
con-temnere -mpsisse -mptum	despise, scorn
condiciō -ōnis f	condition
commūnis -e	common
classis -is f	fleet
cārus -a -um	dear
audācia -ae f	boldness, audacity
armāre	arm, equip
amphitheātrum -ī n	amphitheater
amīcitia -ae f	friendship
ali-quot indēcl	some, several
ali-quandō	once
adversus -a -um	contrary, unfavorable
ad-iuvāre	help
vulnus -eris n	wound
vulnerāre	wound
virtūs -ūtis f	valor, courage
ūnī -ae -a	one
ultrā prp +acc	beyond
ulterior -ius comp	farther, more distant
trīnī -ae -a	three
trāns-īre -eō -iisse -itum	cross, pass
trāns-ferre	transfer, transport
tam-diū	so long, as long
studium -ī n	interest, study
studēre +dat	devote oneself to
stipendium -ī n	soldier's pay, service
sēnī -ae -a	six (each)
secundum prp +acc	along
rīpa -ae f	bank (of a river)
rīdiculus -a -um	ridiculous
re-ferre rettulisse	bring back, return
ratis -is f	raft
quīnī -ae -a	five (each)
quaternī -ae -a	four (each)
quam-diū	how long, (as long) as
pūblicus -a -um	public, State-
properāre	hurry
prō-gredī -ior -gressum	go forward, advance
proelium -ī n	battle
prō-currere -rrisse -rsum	run forward, charge
prīvātus -a -um	private
prī-diē	the day before
prae-stāre -stitisse	furnish, fulfill
praecipuē	especially, above all
posterus -a -um	next, following
plērī-que plērae- plēra-	most, most people
pāx pācis f	peace
ōrdō -inis m	row, rank, order
mūnīre	fortify
mīlitāris -e	military
legiōnārius -a -um	legionary
legiō -ōnis f	legion
lēgātus -ī m	envoy, delegate
īn-struere -ūxisse -ūctum	draw up, arrange
incolumis -e	unharmed, safe
imperātor -ōris m	(commanding) general
idōneus -a -um	fit, suitable
hortārī	encourage, urge
horrendus -a -um	dreadful
gaudium -ī n	joy, delight
foris -is f	leaf of a door, door
ferē	about, almost
fatīgāre	tire out, weary
ex-currere -rrisse -rsum	run out, rush out
etiam atque etiam	again and again
et-enim	and indeed, for
ē-rumpere	break out
ēnsis -is m	sword
ef-fundere	pour out, shed
dīrus -a -um	dreadful
dēsīderāre	long for, miss
dēnī -ae -a	ten (each)
cōpulāre	join, connect
con-vocāre	call together
com-memorāre	mention
cohors -rtis f	cohort
cōgere co-ēgisse -āctum	compel, force
citrā prp +acc	on this side of
citerior -ius comp	nearer
circum-dare	surround
caedēs -is f	killing, slaughter
caedere cecidisse caesum	beat, fell, kill
auxilia -ōrum n pl	auxiliary forces
arduus -a -um	steep
amnis -is m	river
agmen -inis n	army on the march, file
aetās -ātis f	age
ad-iungere	join to, add
aciēs -ēī f	line of battle
versiculus -ī m	short verse
venustus -a -um	charming
ultimus -a -um sup	most distant, last
turgid(ul)us -a -um	swollen
theātrum -ī n	theater
testis -is m/f	witness
tenebricōsus -a -um	dark
tenebrae -ārum f pl	darkness
spectātor -ōris m	spectator
sinus -ūs m	fold (of toga)
sērius -a -um	serious
scalpellum -ī n	scalpel, surgical knife
scaenicus -a -um	theatrical
sapere -iō -iisse	be wise, have sense
rīsus -ūs m	laughter, laugh
rēte -is n	net
re-quīrere -sīvisse -sītum	seek, ask
ratiō -ōnis f	reason
prō-silīre -uisse	spring forth
prīncipium -ī n	beginning
poēticus -a -um	poetical
plērumque	mostly
plaudere -sisse (+dat)	clap, applaud
pīpiāre	chirp
perpetuus -a -um	continuous, permanent
passer -eris m	sparrow
palma -ae f	palm
ōscitāre	gape, yawn
opēs -um f pl	resources, wealth
opera -ae f Profecto filius meus non opera medici sanabitur, sed diis iuvantibus spero eum brevi sanum fore.	effort, pains
odium -ī n	hatred
ocellus -ī m	(little) eye
nūbere -psisse +dat	marry
nota -ae f	mark, sign
niveus -a -um	snow-white
modo…modo Ludi circenses me non minus iuvant quam gladiatorii: modo in amphitheatrum, modo in circum eo.	now…now
misellus -a -um Cum Quintus heri de alta arbore cecidisset, pedem eius turgidum vix tetigit, sed misello puero sanguinem misit.	poor, wretched
mēns mentis f	mind
mellītus -a -um	sweet
lūgēre -xisse	mourn
lucerna -ae f	lamp
libēre: libet +dat	it pleases
libenter	with pleasure, gladly
laedere -sisse -sum	injure, hurt
iocōsus -a -um	humorous, funny
inter-dum Consonantes br, gr, cr, tr, quae initium syllabae facere solent (ut li-bri), interdum dividuntur: nig-ros, pat-rem	now and then
inquam	I say
ingenium -ī n	nature, character
im-plicāre -uisse -itum	enfold
gremium -ī n	lap
gladiātōrius -a -um	gladiatorial
gladiātor -ōris m	gladiator
geminus -a -um	twin
favēre fāvisse +dat	favor, support
fātum -ī n	fate, destiny, death
ex-cruciāre	torture, torment
ē-rubēscere -buisse	blush
epigramma -atis n	epigram
ē-līdere -sisse -sum	omit, elide
dum-modo	provided that, if only
uxōrem dūcere	marry
dubius -a -um	undecided, doubtful
dē-vorāre	swallow up, devour
dēliciae -ārum f pl Incipiam a carmine de morte passeris quem Lesbia in deliciis habuerat...	delight, pet
dactylus, -ī (m)	finger, a poetic foot
con-turbāre	mix up, confound
cōmoedia -ae f	comedy
circus -ī m	circle, orbit, circus
circum-silīre	hop about
circēnsis -e	of the circus
circēnsēs -ium m pl	games in the circus
certāre	contend, fight
certāmen -inis n	contest, fight
cachinnus -ī m	laugh, guffaw
bellus -a -um	lovely, pretty
bāsium -ī n	kiss
aurīga -ae m	charioteer, driver
arānea -ae f	spider, cobweb
anus -ūs f	old woman
af-firmāre	assert, affirm
ācer -cris -cre	keen, active, fierce
accendere -disse -ēnsum	light, inflame
tantun-dem	just as much
speciēs -ēī f Potestas coniunctionum quot species habet? (Quinque: Copulativas, disunctivas, expletivas, causales, rationales)	appearance, aspect, sort
sī-quidem	seeing that, since
similis -e	similar, like
significātiō -ōnis f	meaning, sense
scamnum -ī n	stool
sacerdōs sacerdōtis m/f	priest, priestess
quidnī	why not
quā-propter	why
quantitās -ātis f	quantity, size
quālitās -ātis f	quality
propter-eā	therefore
proprius -a -um	own, proper
ōrdināre	arrange, regulate
ōrātiō -ōnis f	speech
Mūsa -ae f	Muse
mentiō -ōnis f	mention
luctārī	wrestle
īra -ae f	anger
inconditus -a -um	unpolished, rough
forsitan	perhaps, maybe
ex-plētīvus, -a, -um	explanatory
ex-plānāre	explain
ēn	look, here is
dumtaxat	only, just
disiūnctīvus, -a, -um	contrasting
dēmere -mpsisse -mptum	remove
con-iungere	join, connect
cis prp +acc	on this side of
causalis, -e	causal
affectus -ūs m	mood, feeling
ad-nectere -xuisse -xum	attach, connect
admīrātiō -ōnis f	wonder, admiration
imperō, imperāre, imperāvī, imperātum	command, order, rule
Nautae tempestātēs metuunt, nam magnī flūctūs nāvēs aquā implēre possunt.	
Lēonardo	vince's son beard, cuddly, barman at maypole , recently come of age?